terrain.png 81 57 114
1
80
15 15
80 80 80 80 80 80 80 80 80 80 80 80 80 80 80
80 0  0  0  0  0  0  0  0  0  0  0  1  0  80
80 0  0  0  0  0  0  0  0  0  0  1  0  1  80
80 0  0  0  0  0  0  0  0  0  0  0  1  0  80
80 0  0  0  1  0  0  0  0  0  0  0  0  0  80
80 0  0  0  0  0  0  0  0  0  0  1  0  0  80
80 0  0  0  0  0  0  0  1  0  0  0  0  0  80
80 0  0  0  0  0  0  0  0  0  0  0  0  0  80
80 0  0  1  0  0  0  0  0  0  0  0  0  0  80
80 0  0  0  0  0  0  0  0  0  0  0  0  0  80
80 0  0  0  0  0  0  0  0  0  0  1  0  0  80
80 0  0  0  1  0  0  0  0  0  0  0  0  0  80
80 0  0  0  0  0  0  0  1  0  0  0  0  0  80
80 0  0  0  0  0  0  0  0  0  0  0  0  0  80
80 80 80 80 80 80 80 80 80 80 80 80 80 80 80
2 2
12 12
3
4 4
10 3
3 12